10 10
##########
#........#
#.....##.#
#M...#...#
#...##...#
#........#
#.##.##..#
#........#
#........#
##########
