10 10
##########
#........#
#.....##.#
#....#...#
#...##...#
#........#
#.##.##..#
#........#
#........#
##########
